*                                                          *
*                                                          *
*                                                          *
*                                                          *
*                                                          *
*                                                          *
*                     *****************                    *
*                      *             *                     *
*                       *           *                      *
*                        *         *                       *
*                         *       *                        *
*                          *     *                         *
*                           *   *                          *
*                            * *                           *
*                             *                            *
*                            * *                           *
*                           *   *                          *
*                          *     *                         *
*                         *       *                        *
*                        *         *                       *
*                       *           *                      *
*                      *             *                     *
*                     *****************                    *
*                                                          *
*                                                          *
*                                                          *
*                                                          *
*                                                          *
*                                                          *
*                                                          *