*                                                          *
*                                                          *
*                                                          *
*                                                          *
*                                                          *
*                                                          *
*               **************************                 *
*                                                          *
*                                                          *
*                       **********                         *
*                        ********                          *
*                         ******                           *
*                          ****                            *
*                           **                             *
*                                                          *
*                           **                             *
*                          ****                            *
*                         ******                           *
*                        ********                          *
*                       **********                         *
*                                                          *
*                                                          *
*               **************************                 *
*                                                          *
*                                                          *
*                                                          *
*                                                          *
*                                                          *
*                                                          *
*                                                          *